abbreviation	abbreviation[әbriːviˊeiʃәn]n. 缩写 abbreviation[ә,briːviˊeiʃәn]n. 缩写;
absence		absence[ˊæbsns]n. 缺席,不在;缺少,没有 absence[ˊæbsәns]n. 缺乏,没有;
accordingly	accordingly[әˊkɒːdiŋli]ad. 因此,于是,如前所说,相应地 accordingly[әˊkɒːdiŋli]ad. 因此,于是,如前所说;
accuracy	accuracy[ˊækjurәsi]n. 准确,精确度 accuracy[ˊækjurәsi]n. 精确,正确;
accurate	accurate[ˊækjurit]a. 准确的;精确的 accurate[ˊækjurit]a. 正确的;
act on	act onv. 对…起作用,按…行动 act on按照…而行动
adequate	adequate[ˊædikwit]a. 足够的,充分的;适当的,适合的 adequate[ˊædikwit]a. 适当的,足够的;
adjustment	adjustment[әˊdʒʌstmәnt]n. 调整,调节,校正 adjustment[әˊdʒʌstmәnt]n. 调整,调节;
advertise	advertise[ˊædvәtaiz]v. 做广告,登广告,发告示;宣传,宣扬 advertiser[ˊædvәtaizә]n. 广告者,广告客户;
advertisement	advertisement[әdˊvәːtismәnt]n. 广告,告示,宣传,宣扬 advertisement[әdˊvәːtismәnt]n. 广告,启事,做广告;
along with	along with同…一道(一起)
along wwith	====================
alternately	alternately[ˊɒːltәnitli]ad. 交替地,隔一个地 alternately[ɒːlˊtәːnitli]ad. 交替地,隔一个地;
amortize	amortize[әmɒːtaiz]vt. 摊还,摊销,分期偿还,缓冲 amortizev. 摊还,摊销;
amplified	amplify[ˊæmplifai]vt. 扩大,详述,使增幅vi. 引伸 amplify[ˊæmplifai]v. 扩大,详述,使...增幅;
angle	angle[ˊæŋgl]n. 角,角落vi. 钓鱼,夺取,追逐,转变角度vt. 使转动角度 mangle[ˊmæŋgl]vt.乱砍; 割碎; 弄伤
angle bracket	angle bracketangle bracket n 1: either of two punctuation marks (`<' or `>') sometimes used to enclose textual material
anomaly	anomaly[әˊnɒmәli]n. 不规则,异常的人或物 anomaly[әˊnɒmәli]n. 不规则,异常的人或物;
aperiodic	[ˊeipiәriˊɒdik]a. 非周期的 
aperiodic	[ˊeipiәriˊɒdik]a. 非周期的 
apparent	apparent[әˊpærәnt]a. 明显的,显而易见的;表观,视,外显 apparentea. 明显的;
appletalk	appletalk[ˊæpltɒːk]对话 ; 网络协议,(由苹果电脑公司开发出的一种网络协议。用于苹果计算机与其它种类计算机的通信上)
appropriate	appropriate[әˊprәuprieit]a. 适当的,合适的n. 拨出,挪用,盗用 appropriate[әˊprәupriit]a. 适当的;
approve	approve[әˊpruːv]vt. 批准,通过;赞成,称许vi. 赞成,称许 approverapprover n : an authority with power to approve
approximately	approximately[әˊprɒksәmeitli]ad. 大约,大致,近乎 approximately[әˊprɒksimitli]ad. 大约,大致,近乎;
ass		[æs]n. 驴,蠢驴,傻瓜;屁股 ass[æs]n. 驴,傻瓜,笨蛋;
associate	associate[әˊsәuʃieit]vt. 使发生联系,使联合;把…联想起来vi. 交往,结交n. 合伙人,同事a. 副的
associate with	associate with使...与...相联系
asterisk	asterisk[ˊæstәrisk]n. 星号 asterisk[ˊæstәrisk]n. 星号;
asymmetric	[æsiˊmetrik]a. 不均匀的;不对称的 
asymmetrical	[æsiˊmetrikәl]a. 不均匀;不对称的 
asynchronous	asynchronous异步的,异步 asynchronousa.异步的，非同步的
attach	Attach[әˊtætʃ]vt. 使…附属于…,把…附加在…,系上,缚上,使依附 attachen. 大使随员,大使馆馆员;
authentication	authentication[ɒːθentiˊkeiʃәn]n. 证明,鉴定;(判别是否为同一人或同一程序的辨认程序) authenticationn. 证明,鉴定;
authoritative	authoritative[ɒːˊθɑːitәtiv]a. 权威的,有权威的,命令式的 authoritative[ɒːˊθɒritәtiv]a. 权威的,有权威的,命令式的;
autonomous	autonomous[ɒːˊtɒnәmәs]a. 自治的 autonomousa. 自治的;
avoidance	avoidance[әˊvɒidәns]n. 避免,避开,逃避 avoidancen. 避免,避开,逃避;
axis	Axis[ˊæksis]n. 坐标轴,轴,轴线,轴心 taxisn. 脱肠还纳术,整腹术,反射运动;
backbone	backbone[ˊbækboun]n. 脊椎,志气,骨干,支柱 ; 主干,(网络中主要计算机间的连接线路, 在网络主干上有一些连着局域网络的分支) backboneda. 有脊骨的,有脊椎的,有骨气的;
backoff	backoff[ˊbækɒːf]退避
basis	basis[ˊbeisis]n. 基础,主要成分 basis[ˊbeisis]n. 基础;
be placed into	====================
be tie to	====================
be up to	be up to该由…负责；胜任
bit stuffing	====================
bogus	bogus[ˊbougәs]a. 假的,伪造的 bogus[ˊbougәs]a. 假的,伪造的;
bootstrap	bootstrap[ˊbuːtstræp]n. 拔靴带 bootstrapn. 拔靴带;
border	border[ˊbɒːdә]n. 边框n. 边缘,边境,花坛vt. 在…上镶边,接近vi. 接界,近似 border[ˊbɒːdә]n. 边缘;v. 作...之疆界,加边;
bracket	bracket[ˊbrækit]n. 括弧,括号;托架;阶层v. 放在括号里,暂停;相提并论 brackets方括号
bring down	bring down降低,使下降,使泄气 bring down降低
broadcast	broadcast[ˊbrɒːdkæst]n. 广播,广播节目a. 广播的vt. vi. 广播ad. 经广播,四散地 ; (网络上所有结点都能接收到的一种数据包) 
bulk	bulk[bʌlk]n. 大小,体积,大批,大多数vt. 显得大,显得重要 bulky[ˊbʌlki]a. 庞大的;
by convention	====================
bypass	bypass[ˊbaipɑːs]n. 旁路vt. 省略,绕过,忽视,回避 bypass[ˊbai-paːs]v. 省略;
cable	cable[ˊkeibl]n. 电缆,海底电报,缆,索vi. 打海底电报vt. 发海底电报,缚住 cabletn. 周围 10 英寸以下的九股扭成的钢索;
calculation	calculation[kælkjuˊleiʃәn]n. 计算,考虑,计算的结果 calculation[,kælkjuˊleiʃәn]n. 计算,考虑,计算的结果;
campus	campus[ˊkæmpәs]n. 校园,大学教育 campus[ˊkæmpәs]n. 校园,大学教育;
capable	capable[ˊkeipәbl]a. 有能力的,有才能的,有技能的;能…的,可以…的 capable[ˊkeipәbl]a. 有能力的,能的,能干的;
capablesimplex	====================
capitalize	capitalize[kәˊpitәlaiz]vt. 以大写字母写,使资本化,计算…的现价 capitalizeda.大写的
carrier	carrier[ˊkæriә]n. 搬运者,携带者,载体,媒介 carrier[ˊkæriә]n. 运送者,邮务士,带菌者;
carrier sense	====================
checksum	checksumchecksum n : a digit representing the sum of the digits in an instance of digital data; used to check whether errors have occurred in transmission or storage
chronology	chronology[krәˊnɒkәdʒi]n. 年代学;年代记 chronologyn.年代学;按年月次序的排列;年表
clue	clue[kluː]n. 线索,暗示,情节vt. 暗示,提供线索 clue[kluː]n. 线索,暗示,情节;
cogent		[ˊkoudʒәnt]a. 使人首肯的,使人信服的,切实的 cogent[ˊkoudʒәnt]a. 使人首肯的,使人信服的,切实的;
collection	collection[kәˊlekʃәn]n. 收集,聚集,积累,收藏,募捐;文集,数集 collection[kәˊlekʃәn]n. 收集,采集,文集;
colliding	====================
collision	collision[kәˊliʒәn]n. 碰撞,冲突,抵触 collision[kәˊliʒ(ә)n]n. 碰撞,冲突,砥触;
committee	committee[kәˊmiti]n. 委员会,全体委员 committee[kәˊmiti]n. 委员会;
complement	complement[ˊkɒmplimәnt]n. 补足物,补语,余角vt. 补助,补足 complement[ˊkәmplimәnt]n. 补足物,补语,余角;v. 补助;
complexity	complexity[kәmˊpleksiti]n. 复杂,复杂性,复杂的事物 complexity[kәmˊpleksiti]n. 复杂,复杂性,复杂的事物;
complication	complication[kɒmpliˊkeiʃәn]n. 复杂化,使复杂的因素 complication[,kɒmpliˊkeiʃәn]n. 复杂化,使...复杂的因素;
comprehend	[kɒmpriˊhen]vt. 理解,包括 comprehend[,kɒmpriˊhend]vt.了解; 领会; 包含
compress	compress[kәmˊpres]vt. 压缩,压榨vi. 经压缩 compress[kәmˊpres]v. 压缩,压榨;
concurrent	concurrent[kәnˊkʌrәnt]n. 同时发生的事件a. 同时发生的,一致的 concurrent[kәnˊkʌrәnt]n. 同时发生的事件;a. 同时发生的,一致的;
configurable	configurablea. 结构的;
confusingly	confusingly adv : in a bewildering and confusing manner; "her situation was bewilderingly unclear" [syn: {bewilderingly}]
congestion	congestion[kәnˊdʒestʃәn]n. 堵塞,充满,拥挤 ; 阻塞,(这种情况常发生于负载超过数据通路容量的时候) congestionn. 混杂,拥挤,过剩;
connectivity	[kәˊnektiviti]连通度,连通性 connectivityn.连通性，联络性
consecutive	consecutive[kәnˊsekjutiv]a. 连续的,联贯的,始终一贯的 consecutive[kәnˊsekjutiv]a. 连续的,联贯的,始终一贯的;
conserve	conserve[kәnˊsәːv]n. 蜜饯,果酱vt. 保存,保全 conserve[kәnˊsәːv]n. 蜜饯,果酱;v. 保存,保全;
consideration	consideration[kәnsidәˊreiʃәn]n. 考虑,思考;要考虑的事;体谅,关心 consideration[kәn,sidәˊreiʃәn]n. 考虑,原因;
consider	consider[kәnˊsidә]vt. 认为;考虑;体谅,照顾vi. 考虑,思考 consider[kәnˊsidә]v. 考虑,思考,认为;
continental	continental[kɒntәˊnentl]a. 大陆的,洲的n. 欧洲大陆人 continental[,kɒntiˊnentl]a. 大陆的,洲的;
convergence	convergence[kәnˊvәːdʒәns]n. 集中,收敛 convergencen. 集中,收敛;
corporation	corporation[kɒːpәˊreiʃәn]n. 公司,企业n. 社团,团体 corporation[,kɒːpәˊreiʃәn]n. 公司,合作,法人团体;
corrupt	corrupt[kәˊrʌpt]a. 腐败的,贪污的,败德的,讹用的vt. 使腐烂,腐蚀,使恶化vi. 腐烂,堕落 corrupt[kәˊrʌpt]a. 腐败的,贪污的,败德的;v. 使...腐烂,使...恶化;
crc	CRC循环冗余校验
CSMA/CD	CSMA/CD载波监听多路访问/冲突检测
cyclic redundancy check	Cyclic Redundancy Check循环冗余校验,(简称为CRC。它是在发收数据时,确保数据准确的一种检验方式) cyclic redundancy checkcyclic redundancy check n : an error correction code that is recorded in each sector of a magnetic disk and used to catch errors in the data
dash	dash[dæʃ]n. 冲撞,破折号vi. 猛掷,冲撞vt. 泼溅,使猛撞,搀加,使破灭,使沮丧,匆忙完成 dash[dæʃ]n. 冲撞,破折号;v. 猛掷,泼溅,冲撞;
datagram	datagram数据报
date back to	date back to追溯到；从…开始有
DDN	oddness[ɒdnis]n. 奇怪,奇妙 oddnessn. 奇怪,奇妙;
de facto	de factode facto adj : existing in fact whether with lawful authority or not; "de facto segregation is as real as segration imposed by law"; "a de facto state of war" [syn: {actual}, {factual}] [ant: {de jure}] adv : in reality or fact; "the result was, de facto, a one-party system"
defense	defense[diˊfens]n. 防卫,防卫物 defense[diˊfens]n. 防卫,防卫物;
demultiplex	demultiplex多路分用
denote	denote[diˊnout]vt. 指示,表示 denoter标志符; 标志牌
deprecate	deprecate[ˊdeprәkeit]vt. 声明不赞成,抨击,反对 deprecate[ˊdeprikeit]v. 声明不赞成,抨击,反对;
designation	designation[dezigˊneiʃәn]n. 指示,指定,指名 designationn. 指示,指定,指名;
destine	destine[ˊdestin]vt. 注定,预定 destineda. 命中注定的；预定的
diagnostic	diagnostic[daiәgˊnɒstik]a. 诊断的,诊断上有价值的,特征的n. 诊断,病的征候,诊断法 diagnostics诊断
dialup	====================
dimension	[diˊmenʃәn]n. 尺寸,次元,容积,维数vt. 表出尺寸 dimension[diˊmenʃәn]n. 尺寸,次元,容积;
discard	discard[disˊkɑːd,ˊdiskɑːd]vt. 丢弃,抛弃,解雇vi. 垫牌n. 垫牌,抛弃 discard[disˊkɑːd]v. 丢弃,抛弃,解雇;
disgusting hack	====================
domestic	domestic[dәˊmestik]a. 家里的,家庭的;本国的,国内的;驯养的 domestic[dәˊmestik]a. 家庭的,国内的,驯服的;
drawback	drawback[ˊdrɒːbæk]n. 不利点,退税 drawback[ˊdrɒːbæk]n. 不利点,退税;
dumb	dumb[dʌm]a. 哑的,哑巴的,无声的,沉默的 dumb[dʌm]a. 哑的,不说话的,无声音的;
duplicate	duplicate[ˊdjuːplikeit]vt. 复制,使加倍n. 复制n. 副本,复本,复制品a. 复制的,二重的 duplicatedv. 复制,复写;vbl. 复制,复写;
duplication	duplication[djuːpliˊkeiʃәn]n. 副本,复制 duplicationn. 副本,复制;
embed	embed[imˊbed]v. 嵌入vt. 使插入,使嵌入,深留 embed[imˊbed]v. 使插入,使嵌入,深留;
encapsulation	encapsulation[inkæpjuˊleiʃәn]封装 ; (指将一些必要信息加在不同层次协议数据单元之前,Internet中的每一数据包的开始信息,将分别是实体层,IP层,TCP层,再至应用层) encapsulation封装
end up with	end up with以…而结束
enumerate	enumerate[iˊnjuːmәreit]vt. 列举,计算,枚举,数 enumerate[iˊnjuːmәreit]v. 列举,计算,枚举;
ephemeral	ephemeral[iˊfemәrәl]a. 朝生暮死,短命,短暂的 ephemerala. 朝生暮死,短命,短暂的;
erroneous	erroneous[iˊrouniәs]a. 错误的,不正确的 erroneous[iˊrәunjәs]a. 错误的;
essential	essential[iˊsenʃәl]a. 必要的,必不可少的;本质的,基本的n. 要素,要点 essential[iˊsenʃәl]n. 要素,要点;a. 必要的,重要的,本质的;
establish	establish[isˊtæbliʃ]vt. 建立,设立;安置,使定居;确立,使确认 establish[isˊtæbliʃ]v. 建立,确立,制定;
ethernet	Ethernet以太网 ; (一种以基频通讯技术为基础的高传输网络硬件标准。是一个很受欢迎的局域网络) Ethernetn.[计算机]以太网;
examine		[igˊzæmin]vt. 检查,细查;对…进行考试vi. 检查,细查,调查 examine[igˊzæmin]v. 检查,调查,考试;
expiration	expiration[ˊekspaiәˊreiʃәn]n. 呼气,断气;期满,截止 expirationn. 呼出,呼气,终止;
exponential	Exponential[ekspouˊnenʃәl]n. 指数a. 指数的,幂数的 exponentiala. 指数的,幂数的;
exterior	[eksˊtiriә]n. 外部,表面,外型a. 外部的,外在的,表面的 exterior[eksˊtiәriә]n. 外部,表面,外型;a. 外部的,外在的,表面的;
extrapolate	extrapolate[eksˊtræpәleit]vt. vi. 推断,外推 extrapolatev．预测,推测
facto	factor[ˊfæktә]n. 因素,要素;因子,因数,系数 factor[ˊfæktә]n. 因素,因数,代理人;
fallen
fall out	fall out吵翻,闹翻;离队,解散;发生,结果是 fall out争吵；闹翻；结果
field	afield[әˊfiːld]ad. 至野外,在田野,至远方 field[fiːld]n. 领域,田地,场地;
finer	finer[ˊfainә]a. 好的,出色的 fineryn. 装饰,服饰,鲜艳服装;
forbidden	forbidden[fәˊbidn]a. 被禁止的,严禁的n. vbl. forbid的过去分词 forbidden[fәˊbidn]a. 被禁止的,严禁的;v. 禁止,不准;
forward	forward[ˊfɒːwәd]a. 向前的,早的,迅速的,在前的,进步的vt. 转寄,促进,运送ad. 向前地; 转信,(可将某封信件转送给某位用户或某一站) forwards[ˊfɒːwәdz]ad,向前
fragmentation	fragmentation[frægmәnˊteiʃәn]n. 分裂,破碎 ; (在IP层将数据包分割成适合实体网络传输所能接受大小的程序) fragmentationn. 分裂,破碎;
frame	frame[freim]n. 框架,结构,体格vt. 构成,设计,制定,使适合,陷害; 框架,(是指在数据链路层中,将网络层数据包加上开始与结尾信息包组成一个框架) frame[freim]n. 框,结构,体格;v. 构成,设计,陷害;
fruitless	fruitless[ˊfruːtlis]a. 不结果的,不长果实的,无子的 fruitlessa. 不结果的,不长果实的,无子的;
full-duplex	====================
gemini	GeminiGemini n 1: (astrology) a person who is born while the sun in in Gemini [syn: {Twin}] 2: a zodiacal constellation in the northern hemisphere between Taurus and Cancer on the ecliptic 3: the third sign of the zodiac; the sun is in this sign from about May 21 to June 20 [syn: {Gemini the Twins}, {Twins}]
give up	give up停止,放弃;让;认输,投降 give up放弃
gratuitous	gratuitous[grәˊtjuːitәs]a. 免费的,无理由的 gratuitous[grәˊtjuitәs]a. 免费的,无理由的;
guarantee	guarantee[gærәnˊtiː]n. 担保,抵押品,保证书vt. 保证,担保 guarantee[,gærәnˊtiː]n. 担保,抵押品,保证书;v. 保证,担保;
handy	handy[ˊhændi]a. 手边的,近便的;便于使用的 shandyshandy n : a drink made of beer and lemonade [syn: {shandygaff}]
hardwire	hardwired硬连线的
hierarchical	hierarchical[haiәˊraːkikәl]分级的,层次的 hierarchicala.分级的，分层的
hold up		把…举起来;坚持;阻挡,阻碍;抢劫,拦劫 hole uphole up v 1: remain secluded or in hiding; 
host-specific	====================
identical	identical[aiˊdentikәl]a. 同一的;完全相同的,相等的;有同一原因的,有同一来源的 identical[aiˊdentikәl]a. 同一的,完全相同的;
ieee	IEEE电机与电子工程师学会
implication	implication[impliˊkeiʃәn]n. 意涵,暗示,暗指 implication[impliˊkeiʃәn]n. 含意,暗示;
imply	imply[imˊplai]vt. 含有…的意思;暗指,暗示,意指 simply[ˊsimpli]ad. 只是,简直,只须;
imprecision	imprecision n : the quality of lacking precision [syn: {impreciseness}] [ant: {preciseness}, {preciseness}]
improperly	improperly[imˊprɒpәli]ad. 不适当地;错误地 improper[imˊprɒpә]a. 不合适的,错误的,不道德的;
in addition to	in addition to除…之外(还有)
inclusion	inclusion[inˊkluʒәn]n. 包含,内含物 inclusionn. 包含;
incomplete	incomplete[inkәmˊpliːt]a. 不完全的,不定的 incomplete[,inkәmˊpliːt]a. 不完全的,不定的;
incorrectly	incorrectly不正确地 incorrect[,inkәˊrekt]a. 不正确的;
incremental	[inkriˊmentl]a. 增加的 incremental增量的
indeed	indeed[inˊdiːd]ad. 真正地,实际上;确实,实在;当然,固然;甚至;真的 indeed[inˊdiːd]ad. 的确,实在;
indefinitely	indefinitely[inˊdefinitli]ad. 不确定地 indefinitely[inˊdefinitli]ad.无限地，无穷地
indispensable	indispensable[indisˊpensәbl]n. 不可缺少之物a. 不可缺少的,不能避免的,绝对必要的 indispensable[,indisˊpensәbl]n. 不可缺少之物;a. 不可缺少的,不能避免的,绝对必要的;
infer		[inˊfәː]vt. 推论,推断;意味着vi. 作出推论 infer[inˊfәː]v. 推论出,推断;
infrastructure	infrastructure[ˊinfrәstrʌktʃә]n. 下部构造,基础下部组织 infrastructuren. 下部构造,下部组织;
institution	institution[instiˊtjuːʃәn]n. U建立,设立;C公共机构 institution[,instiˊtjuːʃәn]n. 机构,惯例,创立;
interactive	interactive[intәrˊæktiv]交互的,互相影响的,交互 interactivea.交互式，交互的
interdomain	====================
intermediate	Intermediate[intәˊmiːdiәt]n. 中级n. 中间物,调停者a. 中间的,中级的vi. 起媒介作用 
intermix	intermix[intәˊmiks]vt. vi. (使)混和,(使)混杂 intermixv. 混入,混杂;
internet	internet n. 互联网络(由interconnection network 组合成的新词，通过TCP/IP通讯协议，连结全世界的计算机网络，实现服务与资源的共享，它可提供 ftp，gopher，wais，news，telnet等服务) Internet网际
Internet	internet n. 互联网络(由interconnection network 组合成的新词，通过TCP/IP通讯协议，连结全世界的计算机网络，实现服务与资源的共享，它可提供 ftp，gopher，wais，news，telnet等服务) Internet网际
interoperate	interoperate互操作
interval	Interval[ˊintәvl]n. 时间间隔n. 间隔,距离,间歇,间隙 intervalen. 丘陵间低地;
invalid	invalid[ˊinvәlid]n. 病人,残废者a. 有病的,残废的,无效的 invalid[ˊinvәliːd, inˊvælid]n. 病人,残废者;a. 有病的,残废的,无效的;
involve	involve[inˊvɒlv]vt. 包缠;使卷入,使陷入;使专注;必须包括;包围 involveda.有关的
issue	issue[ˊisjuː,ˊiʃjuː]n. C流出,放出;U发行;C问题vt. 使流出,放出;发行,发布;发给,配给vi. 出 tissue[ˊtisjuː]n. 薄的纱织品,组织;
lalance	====================
latency	latency[ˊleitnsi]n. 潜伏,潜在 latencyn. 潜伏,潜在;
logarithmic	Logarithmic[lɒːgәˊriðmik]a. 对数的 logarithmica. 对数的;
loose	loose[luːs]n. 解放,放任,放纵a. 宽松的,松的,宽的,不牢固的,散漫的,自由的 loosen[ˊluːsn]v. 放松,松开,解除;
make into	制成做成；使转变为
make no sense	====================
make sense	make sense合理,可行;有意义,说得通 make sense讲得通；很有意义
malicious	malicious[mәˊliʃәs]a. 怀恶意的,恶毒的 malicious[mәˊliʃәs]a. 怀恶意的,恶毒的;
manufacturer	manufacturer[mænjuˊfæktʃәrә]n. 制造商,制造厂 manufacturer[,mænjuˊfæktʃәrә]n. 制造业者,厂商;
mechanism	mechanism[ˊmekәnizm]n. 机械,机构,结构,机理,技巧 mechanism[ˊmekәnizәm]n. 机械,机构,结构;
medium	medium[ˊmiːdjәm]n. 中间,中庸,平均数,介质,媒介;媒体,手段,方法,宣传工具; medium[ˊmiːdjәm]n. 媒体,方法,媒介;a. 半生熟的,中的;
medium-size	medium-sizeda. 中型的,普通型的
metric	Metric[ˊmetrik]a. 公尺的,公制的,计量的 metricsn. 韵律学,作诗法;
military	military[ˊmilitәri]n. 军队a. 军事的,军人的,好战的 military[ˊmilitәri]n. 军队;a. 军事的,军人的,好战的;
millisecond	millisecond[ˊmilidekәnd]千分之一秒,毫秒 millisecond毫秒
misbehave	misbehave[ˊmisbiˊheiv]vt. vi. (使)行为无礼貌,(使)行为不端 misbehave v. 行为无礼貌,行为不端,作弊;
modulation	modulation[mɒdjuˊleiʃәn]n. 调音,调节,抑扬 modulationn. 调音,调节,抑扬;
module	Module[ˊmɒdjuːl]n. 模块n. 组件,模 module[ˊmɒdjuːl]n. 组件;
monetary	monetary[ˊmʌnitәri]a. 货币的,金钱的 monetary[ˊmʌnitәri]a. 货币的,金钱的;
mtu	MTU最大传输单元,( MAXIMUM TRANSMISSION UNIT 的缩写。PPP模式中一次传送数据的最大量)
multihome	====================
multihomed	====================
netblazer	====================
netotiate	====================
notable	notable[ˊnoutәbl]n. 著名人士,值得注意之事物a. 值得注意的,显著的,善理家的 notable[ˊnәutәbl]n. 著名人士,值得注意之事物;a. 值得注意的,显著的,善理家的;
notation	notation[nouˊteiʃәn]n. 记号法,表示法,注释 notationn. 记号法,表示法,注释;
obviate	obviate[ˊɒbvieit]vt. 除去,排除,回避,预防,避免 obviate[ˊɒbvieit]v. 除去,排除,回避;
odd	coddle[ˊkɒdl]vt. 娇养,溺爱,煮蛋n. 娇生惯养的人,宝贝子弟,娇养小孩的人 noddv. 点头;打盹;疏忽;失误;倾斜;摇摆
on the inside front cover	====================
on the wire	====================
oppose	oppose[әˊpouz]vt. 反对,以…对抗,抗争vi. 反对 
originate	Originate[әˊridʒineit]v. 发自vt. 开始,发明,发起vi. 发源,发生 originate[әˊridʒineit]v. 开始,发明,发起;
other than	other than与…不同,除了…;非…,而不是… other than不同于；除了
outbound	Outbound[ˊautbaund]n. 出站a. 开往外地的
outgo	outgo[autˊgou]n. 外出,支出vt. 胜过,优于 outgon. 外出,支出;v. 胜过,优于;
pad	spado[ˊspeidou]n. 无生育能力的人
paragraph	paragraph[ˊpærәgrɑːf]n. 段落,短评vt. 将…分段,分段落vi. 写短评n. 段落 paragraph[ˊpærәgrɑːf]n. 段落,短评;v. 将...分段,分段落;
parenthese	parentheses[pәˊrenθisiːs]n. pl. 括弧,插入语,插曲 parenthesesn. 刮弧;
parse	Parse[pɑːs]n. 分列vt. 解析 sparsea. 稀疏的,稀稀落落的,薄的;
participate	participate[pɑːˊtisipeit]v. 参加,参与;分担,分享;有几分… participate[pɑːˊtisipeit]v. 参加,分享,参与;
particular	particular[pәˊtikjulә]a. 特别的,特殊的,详细的,挑剔的,苛求的n. 细节,细目,详情 particularsn．事实，细节
perceive	perceive[pәˊsiːv]vt. 察觉,感知;理解,领悟 perceiverperceiver n : a person who becomes aware (of things or events) through the senses [syn: {observer}, {beholder}]
periodically	periodically[piәriˊɒdikәli]周期地 periodicallyad.周期性地，定期地
periodic	[ˊpiәriˊɒdik]a. 周期的,定期的;
period		[ˊpiәriәd]n. 时期,节,句点;
perspective	Perspective[pә(ː)ˊspektiv]n. 透视,眼界,视野,前途,希望a. 远景画法的,透视的,远景 
phenomenal	phenomenal[fәˊnɒminl]a. 现象的,能知觉的,异常的 phenomenala. 现象的,能知觉的,异常的;
piece	apiece[әˊpiːs]ad. 每人,每个,各 piece[piːs]n. 块,片,篇;v. 修补,结合;
ping
pitfall	pitfall[ˊpitfɒːl]n. 陷阱,诱惑,阴谋 pitfall[ˊpitfɒːl]n. 陷阱,诱惑,阴谋;
political	apolitical[æpәˊlitikl]a. 不关心政治的 political[pәˊlitikәl]a. 政治上的,政党的,政略性的;
poll	Apollo[әˊpɒlou]n. 阿波罗,美男子 Pollyn. Mary 的昵称;
pound[paund]n. 磅,英镑,重击,鱼塘,拘留所,兽栏vt. 强烈打击,捣烂,监禁 pound[paund]n. 磅,兽栏;v. 强烈打击,连续重击,捣碎;
pound sign	'#'
practical	[ˊpræktikәl]a. 实际的,实践的;实用的,应用的;有实际经验的 practical[ˊpræktikәl]a. 实际的,现实的,实用性的;
precise	precise[priˊsais]a. 精确的,严谨的,明白的 precise[priˊsais]a. 精确的,严谨的,明白的;
predecessor	predecessor[prediˊsesә]n. 前任,先辈,以前的东西 predecessor[ˊpriːdisesә]n. 前任,先辈,以前的东西;
prediction	prediction[priˊdikʃәn]n. 预言,预报 prediction[priˊdikʃәn]n. 预言,预报;
predict	predict[priˊdikt]vt. vi. 预知,预言,预报 predict[priˊdikt]v. 预知,预言,预报;
predominant	predominant[priˊdɒminәnt]a. 优越的,卓越的,有力的 predominant[priˊdɒminәnt]a. 优越的,卓越的,有力的;
preferable	preferable[ˊprefәrәbl]a. 更可取的,更好的,更胜一筹的 preferable[ˊprefәrәbl]a. 较好的,较喜爱的,较合宜的;
preference	preference[ˊprefәrәns]n. 偏爱,优先,优先权,优先的选择 preference[ˊprefәrәns]n. 偏爱,优先,喜爱物;
presentation	Presentation[ˊprezenˊteiʃәn]n. 赠送,呈现,提出,提交;发言,演出 presentation[,prezenˊteiʃәn]n. 赠与,陈述,介绍;
pressure	pressure[ˊpreʃә]n. 压,榨,按,强制,压力,压迫,压强vt. 迫使,使增压,密封 pressure[ˊpreʃә]n. 压力,压迫;
principle	principle[ˊprinsәpl]n. C原理,原则;道义,德行 principle[ˊprinsәpl]n. 原则,原理,主义;
probe	probe[proub]n. 探针,调查,探测针vt. 用探针测,详细调查vi. 探索,调查 prober探针器
promiscuous	promiscuous[prәˊmiskjuәs]a. 杂乱的,混杂的,混淆的ad. 偶然地,胡乱地 promiscuous[prәˊmiskjuәs]a. 杂乱的,混杂的,混淆的;ad. 偶然地,胡乱地;
propagate	propagate[ˊprɒpәgeit]vt. 繁殖,传播,传送vi. 繁殖,蔓延 propagate[ˊprɒpәgeit]v. 繁殖,传播,传送;
proportional	proportional[prәˊpɒːʃәnl]a. 比例的,相称的,调和的n. 比例项 proportional[prәˊpɒːʃәnl]a. 比例的,相称的,调和的;n. 比例项;
proposal	proposal[prәˊpәuzәl]n. 建议,提议,求婚 proposal[prәˊpәuzәl]n. 提议,计划,求婚;
propose	propose[prәˊpouz]vt. 计划,打算,建议,向…提议,求(婚)vi. 打算,求婚 proposern. 申请人,提案人;
protocol	protocol[ˊproutәkәl]n. 协议n. 草案,礼仪vt. vi. 拟定 ; (为使网络中不同系统主机能够彼此进行通讯,所制订的网络管理规则) protocol[ˊproutәkɒl]n.规约，协议，规程
pruned	prune[pruːn]n. 干梅子,梅干,深紫红色,傻瓜vt. 修剪,砍掉,删除vi. 删除,删节 prune[pruːn]n. 干酶子,酶干;v. 修剪,砍掉,删除;
publicly	publicly[ˊpʌblikli]ad. 公然地,舆论上 publicly[ˊpʌblikli]ad. 公然地,舆论上,以公费;
quench	quench[kwentʃ]vt. 熄灭,结束,冷浸,淬火vi. 熄灭,平息 quench[kwentʃ]v. 熄减,结束,冷浸;
query	query[ˊkwiәri]n. 查询n. 疑问,疑问号,质问vt. vi. 询问,质问 query[ˊkwiәri]n. 疑问,疑问号,质问;v. 问;
randomize	randomize随机选择 randomizer随机函数发生器
realistically	realistically[riәˊlistkli]ad. 写实地,逼真地,现实地 realisticallyad. 写实地,逼真地,现实地;
realistic	realistic[riәˊlistik]a. 现实的,逼真的,现实主义的,实在论的 realistic[riәˊlistik]a. 现实的;
rearrange	prearrange[priːәˊreindʒ]vt. 预先安排,预先协定,预定 rearrangev. 再排列,再整理;
reassembly	重新组装
recommended	recommended[rekәˊmendid]推荐的 recommended[,rєkәˊmєndid]被推荐的
recommend	recommend[rekәˊmend]vt. 推荐,介绍;劝告,建议;使成为可取,使受欢迎 recommend[,rekәˊmend]v. 推荐,介绍,托付;
redo	credo[ˊkriːdou]n. 信条 uredo皮肤痒灼感
redundancy	redundancy[riˊdʌndәnsi]冗余 redundancyn．过剩，似乎多余其实重要的后备力量
redundant	redundant[riˊdʌndәnt]a. 多余的,过多的,冗长的 redundant[riˊdʌndәnt]a. 多余的,过多的,冗长的;
reissued	====================
reiterate	reiterate[riːˊitәreit]vt. 反复地说,重申,反复地做 reiterate[riːˊitәreit]v. 反覆地说,反覆地做;
relevant	relevant[ˊrelivәnt]a. 有关联的,中肯的,有关系的,适当的,成比例的,相应的 relevant[ˊrelivәnt]a. 有关联的,有关系的,适切的;
relevant to	与...有关
reliability	reliability[rilaiәˊbiliti]n. 可信度,可靠性,可信赖性 reliability[ri,laiәˊbiliti]n. 可信度,可靠性,可信赖性;
reorder	reorder[ˊriːˊɒːdә]v. 重新排序vt. 重新安排,再订购vi. 再订购n. 再订购 reorderv.(按序)排列，排序
request for comment	====================
resolution	Resolution[rezәˊluːʃәn]n. 图形分辨率n. 解析,决心,坚定,决定,提案,消除,解答,分解,转变 resolution[,rezәˊljuːʃәn]n. 解析度,决心,提案;
resolver	resolver分解器
response	response[risˊpɒns]v. 应答n. 反应,回答,响应 responsesn. 反应,回应,回覆;
restriction	restriction[risˊtrikʃәn]n. 限制,限定,约束,制止,禁止 restriction[risˊtrikʃәn]n. 限制,限定;
retransmission	retransmission重传,重发
retransmit	retransmit重传输; 重复传输 retransmit重新发送
RFC	RFCS( REQUEST FOR COMMENTS 的缩写,计算机与通讯技术文件)
robin	probing[proubiŋ]n. 探求（场附近） robin[ˊrɒbin]n. 知更鸟;
robustness	robustnessrobustness n : the property of strong in constitution [syn: {hardiness}, {lustiness}]
round-trip	round-tripa. 来回旅程的
scenario	脚本 scenario n. 情节,剧本;
serial link	====================
serial	serial[ˊsiәriәl]n. 序列,连载小说a. 连续的,一连串的,连载的,分期偿还的 serialn. 序列,串列;a. 连续的,一连串的;
serious		[ˊsiәriәs]a. 严肃的;严重的,危急的;认真的,不是开玩笑的 serious[ˊsiәriәs]a. 严肃的,认真的;
serous	serous[ˊsiәrәs]a. 浆液的,血浆的,浆液一样的 serousa. 浆液的,血浆的,浆液一样的;
settle	settle[ˊsetl]n. 有背的长凳vt. 决定,整理,安放,使定居,使平静,调停,支付,安排,安放,解决 settler[ˊsetlә]n. 移民者,居留者,赠予者;
shortcome	====================
SLIP	slip[slip]n. v. 滑跤,滑倒,滑落;溜走,悄悄离开,流逝;疏忽,遗忘,弄错,错过 ; 协议名,( SERIAL LINE INTERNET PROTOCOL 的缩写,提供PC用户经由MODEM、电话线连接到INTERNET网络的通信协议) sliptslip的过去式
snmp	SNMP简单网络管理协议
snoop	snoop[snuːp]vi. 偷偷地到处瞧,调查,偷窃,窥探n. 到处窥视,爱管闲事的人,私家侦探 snoopya. 爱窥探者,爱管闲事者;
solicitation	solicitation[sәlisiˊteiʃәn]n. 恳求,恳请,诱惑 solicitationn. 恳求,恳请,诱惑;
sonar	sonar[ˊsounɑː]n. 声纳 sonar[ˊsɒnaː]n. 声纳;
sophisticated	[sәˊfistikeitid]a. 诡辩的,久经世故的;
sophisticate	sophisticate[sәˊfistikeit]n. 久经世故的人,老油条vt. 篡改,曲解,使变得世故,掺合,弄复杂vi. 诡辩 
squiggle	squiggle[ˊskwigl]n. 胡乱写的字 squigglen. 胡乱写的字;
stabilize	stabilize[ˊsteibilaiz]vt. 使安定,使坚固vi. 稳定,安定 stabilizern. 有安定作用之物,安定装置,水平尾翼;
stand for	stand for代表,象征,意味着 stand for代表
stratum	stratum[ˊstreitәm]n. 地层,阶层 stratum[ˊstreitәm]n. 地层,阶层;
stub		[stʌb]n. 断株,烟蒂,树桩,残余,存根vt. 挖除断株,连根拔除,踩熄 stub[stʌb]n. 断株,烟蒂;v. 挖除断株,连根拔除;
stuffing	stuffing[ˊstʌfiŋ]n. 填塞物,剥制,填料 stuffingn. 填塞物,剥制,填料;
subtle	subtle[ˊsʌtl]a. 敏感的,精细的,狡猾的,稀薄的,精巧的,微妙的 subtle[ˊsʌbtl]a. 敏感的,精细的,狡猾的;
subtract	subtract[sәbˊtrækt]vt. 减去,扣掉,减少vi. 作减法 subtract[sәbˊtrækt]v. 减去,扣掉,减少;
summarization	[sʌmәraiˊzeiʃәn]n. 摘要,概要 summarizationn. 摘要,概要;
summary	Summary[ˊsʌmәri]n. 归纳,总结a. 扼要的,简短的 summary[ˊsʌmәri]n. 摘要,概要;a. 摘要的,简略的;
superior	superior[sjuːˊpiәriә]a. 优良的,卓越的,高级的;较…多,优于…的;上层的,上级的n. 上级,长官 
supernet	====================
superset	superset超集
symmetrical	symmetrical[siˊmetrikәl]a. 对称的,均匀的;
symmetric	symmetric adj.对称的，匀称的
synchronization	[siŋkrәnaiˊzeiʃәn]同步 synchronization[,siŋkrәnaiˊzeiʃәn]n.同步
take down	take down记下,录下;取下,拿下 take down拿下
tap		[ˊtæp]n. 轻打,水龙头vt. 轻打,轻敲,敲打出,选择,装上嘴子,使流出,开发,召集,分接 tap[tæp]n. 轻打,水龙头;v. 轻打,轻敲,装上嘴子;
thick	[θik]a. 厚的;密;浓,粘稠的;混浊的,多雾的n. 最厚的部分,最激烈处;笨蛋ad. 厚 thick[θik]a. 厚的,浓的,迟钝的;ad. 厚地,密地,丰富地;
tie		[tai]n. 带子,线,绳;领带;联系;系绳或打结的方法;束缚vt. 系,扎,拴,束紧;把打结 tie[tai]n. 结,束缚,不分胜负;v. 系,打结,约束;
timekeeper	timekeeper[ˊtaimkiːpә]n. 工作时间记录员,计时员,钟表 timekeepern. 工作时间记录员,计时员,钟表;
token ring	token ring令牌环网,(一个环状的局域网络)
token	token[ˊtoukәn]n. 表征,记号,代币a. 象征的,表意的 token[ˊtәukәn]n. 表征，记号,代币;
topology	topology[touˊpɒlәdʒi]n. 地志学,拓扑数学,局部解剖学 topologyn. 地志学,拓扑数学,局部解剖学;
trailer encapsulation	====================
transient	transient[ˊtrænziәnt]n. 暂态,短期居留者,侯鸟,瞬变值a. 短暂的,易变的,瞬变的,路过的 
transit	transit[ˊtrænsit]n. 经过,通行,运输,运输线,转变vt. 横越,通过,经过vi. 通过 transit[ˊtrænsit]n. 经过,运输;v. 横越;
transport	transport[trænsˊpɒːt]n. 传送器,运输,运输机,激动,狂喜,流放犯vt. 传送,运输,流放 
traverse	traverse[ˊtrævәːs]n. 横贯,横木,障碍,否认,反驳vt. 横过,穿过,经过,详细研究,反对 traversern. 横贯者,拒绝者,反驳者;
trivial	trivial[ˊtiviәl]a. 琐细的,日常的,轻微的,平常的 trivial[ˊtriviәl]a. 琐细的,日常的;
ubiquitous	ubiquitous[juːˊbikwitәs]a. 到处存在的,遍在的 ubiquitous[juˊbikwitәs]a. 到处存在的,遍在的;
uncommon	uncommon[ʌnˊkɒmәn]a. 不寻常的,不凡的,罕有的ad. 非常地 uncommon[ʌnˊkɒmәn]a. 不寻常的,不凡的,罕有的;ad. 非常地;
undeliverable	====================
unicast	====================
unique	unique[juːˊniːk]a. 独一无二的,独特的,稀罕的 unique[juːˊniːk]a. 独一无二的,独特的,稀罕的;
uniquit	====================
unqualified
unsolicited	['ʌnsə'lisitid] adj. 未经请求的，主动提供的
useless	useless[ˊjuːslis]a. 无用的,无效的,无益的 useless[ˊjuːzlis]a. 无用的,无效的,无益的;
variable	Variable[ˊvєәriәbl]n. 变量,可变物a. 易变的;可变的;变量的;变异的 variable[ˊvєәriәbl]n. 变数;a. 可变的,不定的;
variance	variance[ˊvєәriәns]n. 不一致,变化,变异,分歧,不和 variancen. 不一致,变化;
various	various[ˊvєәriәs]a. 不同的,各种的,多方面的,许多的,个别的,杂色的 various[ˊvєәriәs]a. 不同的,各种的,多方面的;
versus	versus[ˊvәːsәs]prep.(比赛中的)对...
whereas		[wєәrˊæz]conj. 然而,反之,鉴于;
whereby	whereby[hwєәˊbai]ad. 凭什么;为何;因此 whereby[wєәˊbai]ad.凭什么; 靠那个
workhorse	workhorse n 1: machine that performs dependably under heavy use; "the IBM main frame computers have been the workhorse of the business world" 2: a horse used for plowing and hauling and other heavy labor
y-axis	y-axisy-axis n : the vertical axis in a plane coordinate system
